11111111111111111111111111111111111
11000P00000001111110000000001111111
10000010000000111111000000000111111
10000000010010011111000000001111101
10000000001011011111010000010111001
10000000011101011110010000000010001
10000000011011011100011000000001001
10000000001111001000001100000011001
1000C000010011000100001000000111011
10000000111110000000000100000111001
10010001111011000100001100100001011
10010000111111000101011100100010011
10000000011111000001111100100000111
10000000001110000011011100001000011
1000000001111100010011110001E000101
10000000111111100001111000001000011
11111111111111111111111111111111111