111111111111111111111111111111111
111C11111011111000000011000111111
1000001100011010000001100C0011111
110001100000000100000000000111111
110011000000C00000000001P11110111
110000000000000100000000111110001
110100C00000100000000000001100001
110000000011E00000010000101110001
100000000010100000000001100100011
100000000000110000000011100000111
100000000000111000000011000000011
100100000000011101010011100000001
100000001000111111110011110100011
100000011100011111110001111100001
100000111000001111100000111000001
110001111100011111110001111100011
111111111111111111111111111111111
